30 14
6
1000

------------------------------
------------------------------
--------------------++++++++--
=++++++-------------+------+--
-----N+-------------+------+--
------+-----S-------+------+--
------+++++++++++++++------+--
---------------M-----------+--
---+++++++++++++++++++++++++--
---+M-------------------------
---+---------------------N----
---++++++++++++++++++++++++++$
-----------------A------------
------------------------------
